00000000000000000000
11111111111111111110
11111111111111111110
11111111111111121110
11112111111111111110
11111111111111111110
00000000000000000000
01111111112111111111
01111111111111111111
01111111111111112111
01121111111111111111
01111111111111111111
00000000000000000000
