1111111111000111111111111111111111121111
1111111100000001111111111111111111111111
1111111000000001111111111111111111111111
1111100001111100011111111111111111111111
1111000111111110000112111111221111111111
1100011111111111110111111111111111111111
1000111111144441110111111111111111111111
1001111111144441110111111111111122111111
1111111111144441110111111111111111111111
1111111111144441113111121111111111111111
1111111111111111110111111111111111111111
1111111111111111110111111111111111111111
1111111111111111000111111111111111111111
1111111111111110001111111111111111111111
1111111111111333011111111111111121111111
1111111111100033111111111111111111111111
1111111111000001111112221111111111111111
1111111111000011111111221111111111111111
1111111110000111111111111111111111111111
1111111110001111111111111111111110011111
1211111100011111111111111111111100001111
1111111100111111111111111111111100011111
1111111111111111111111111111111001111111
1111111111111111111111111111111111111111
1111111111110000001111111111111111111111
1111111111110000001111121111111111111111
1111111111111000001111111111111111111111
1111111111100000001111111211111111111111
1211111111100001111111111111111111121111
1111111111111111111112111111111111111111